F 9,7,9
C 10,20, 90

NO rbrd
WE gdfg
SO gdr
EA gdb

111111
10T001
100D01
10S001
111111