
       NO      textures/wolfenstein/purple_stone.xpm



SO textures/wolfenstein/red_brick.xpm

F      17,    38,     64

EA textures/wolfenstein/wood.xpm



C 218, 234, 235

1111111111111111111111111
WE                            textures/wolfenstein/grey_stone.xpm
10S011000010000000000000000000001
100011000000000011111100000000001
1000110000000000110001001
1000000000100000000001001
1111111111111111111111111