
 WE                            textures/west.xpm
       NO      textures/north.xpm



SO textures/south.xpm

F      17,    38,     64

EA textures/east.xpm



C 218, 234, 235

111111111
100000001
111110001
100000001
100000001
100E00001
100000001
100011101
100000001
111111111