
 WE                            textures/wolfenstein/grey_stone.xpm
       NO      textures/wolfenstein/purple_stone.xpm



SO textures/wolfenstein/red_brick.xpm

F      17,    38,     64

EA textures/wolfenstein/wood.xpm



C 218, 234, 235

1111111111111111111111111
110011000010100000000000011111111
  1100011001 100000011111111111111111
1110110000000000110001001
1000000000100000000001001
1111111111111111111111111