WE                            textures/west.xpm
       NO      textures/north.xpm



SO textures/south.xpm

F      17,    38,     64

EA textures/east.xpm
DO textures/wood.xpm
SP1 textures/up.xpm
SP1 textures/down.xpm



C 218, 234, 235

1111111111111111111111
 10000000011110000001
  1000N0000000000001
   1000000011D11111
    10000000000001
     10000T000001
      1000000001
       10000001
        100001
         1001
          11